16 9 6
163 163 163 163 163 163 163 163 163 163 163 163 163 163 163 163
163 163 163 163 163   4  48  48  48  48  48  48   5 163 163 163
163 163 163 163 163  26  61  61  61  61  61  61  24 163 163 163
163 163 163 163  25  26  61   1   2   2   3  61  24 163 163 163
163   4  48  48  48  49  61  24 163 163 243 268 241 161 242 242
163  26  61  61  61  61  61  24 163 163 243 268 264 265 265 265
163  26  61   1   2   2   2  28 163 163 243 268 268 268 268 268
163  26  61  24  25  25 163 163 163 163 244 219 219 219 219 219
163  26  61  24 163 163 163 163 163  25 242 242 242 242 242 242
Target 15 6 1 1 20
NormalAircraftSpawner 2 8 1 1 10 0 10
BigAircraftSpawner 2 8 1 1 10 110 5
TankerSpawner 2 8 1 1 20 170 10
RocketLauncherTower 4 3 90
MachineGunTower 13 4 90
