16 9 9
163 163 163 163 163 163 163 163 163 163 163 163 163 163 163 163
163 163 163 163 163 4 48 48 48 48 48 48 5 163 163 163
163 163 163 163 163 26 1 2 2 2 2 3 24 163 25 25
163 163 163 163 25 26 24 25 25 25 25 26 24 163 25 25
163 4 48 48 48 49 24 25 163 163 25 26 24 25 25 25
163 26 1 2 2 2 28 25 163 163 25 26 47 48 48 48
163 26 24 25 25 25 25 25 163 163 25 27 2 2 2 2
163 26 24 25 232 232 163 163 163 163 25 25 25 25 25 25
163 26 24 25 25 25 25 25 25 25 25 25 25 25 25 25
Target 15 5 1 1 20
NormalAircraftSpawner 1 8 1 1 10 0 1
BigAircraftSpawner 1 8 1 1 10 20 1
TankerSpawner 1 8 1 1 20 30 1
TurnPoint 1 5 1 4 2 4
TurnPoint 4 4 5 4 5 3
TurnPoint 5 2 5 1 6 1
TurnPoint 10 1 11 1 11 2
TurnPoint 11 4 11 5 12 5