16 9 8
25 25 25 25 25 25 25 25 25 25 25 25 25 25 25 25
48 48 48 48 48 48 48 48 48 48 48 48 5  25 25 25
2  2  2  2  2  2  2  2  2  2  2  3  24 25 25 25
25 25 25 25 25 25 25 25 25 25 25 26 24 25 25 25
25 25 25 25 4  48 48 48 48 48 48 49 24 25 25 25
25 25 25 25 26 1  2  2  2  2  2  2  28 25 25 25
25 25 25 25 26 24 25 25 25 25 25 25 25 25 25 25
25 25 25 25 26 47 48 48 48 48 48 48 48 48 48 48
25 25 25 25 27 2  2  2  2  2  2  2  2  2  2  2
Target 15 7 1 1 20
NormalAircraftSpawner 0 1 1 1 30 5 0
BigAircraftSpawner 0 1 1 1 30 20 0
TankerSpawner 0 1 1 1 20 30 40
TurnPoint 10 1 11 1 11 2
TurnPoint 11 3 11 4 10 4
TurnPoint 5 4 4 4 4 5
TurnPoint 4 6 4 7 5 7