16 9 20
242 242 242 242 242 242 242 173 35 36 34 35 35 35 35 35
242 242 242 242 242 242 242 173 35 36 34 35 35 35 35 35
242 242 242 242 242 242 242 173 35 36 57 58 58 58 15 35
265 265 265 265 265 222 242 173 35 37 12 12 12 13 34 35
219 219 219 219 220 241 242 173 35 35 35 35 35 36 34 35
242 242 242 242 243 241 242 35 35 35 35 35 35 36 34 35
242 242 242 242 243 241 242 35 35 35 35 35 35 36 34 35
242 242 242 242 243 264 265 58 58 58 58 58 58 59 34 35
242 242 242 242 244 219 219 12 12 12 12 12 12 12 38 35
Target 9 0 1 1 20
NormalAircraftSpawner 0 3 1 1 30 5 1
TurnPoint 3 3 4 3 4 4
TurnPoint 4 6 4 7 5 7
TurnPoint 12 7 13 7 13 6
TurnPoint 13 3 13 2 12 2
TurnPoint 10 2 9 2 9 1
Bush 2 1 133
Bush 4 8 132
Bush 6 6 132
Bush 9 5 134
Bush 14 2 133
Rock 1 1 136
Rock 0 5 135
Rock 5 2 136
Rock 8 1 136
Rock 1 7 138
Rock 12 6 181
Rock 15 8 137
Rock 15 1 138