16 9 17
25 25 25 25 25 25 25 25 25 25 25 25 25 25 25 25
163 163 163 163 163 4 48 48 48 48 48 48 5 163 163 163
163 25 163 163 163 26 1 2 2 2 2 3 24 163 25 25
163 25 25 25 25 26 24 25 25 25 25 243 241 242 242 242
163 4 48 48 48 49 24 25 163 163 25 243 241 242 242 242
163 26 1 2 2 2 28 25 163 25 25 243 264 265 265 265
163 26 24 25 25 25 25 25 25 25 25 244 219 219 219 219
163 26 24 25 232 25 25 25 25 163 25 242 242 242 242 242
163 26 24 25 25 25 25 25 25 25 25 242 242 242 242 242
Target 14 5 1 1 20
BinLadenBossSpawner 1 7 1 1 30 10000000 1
TurnPoint 1 5 1 4 2 4
TurnPoint 4 4 5 4 5 3
TurnPoint 5 2 5 1 6 1
TurnPoint 10 1 11 1 11 2
TurnPoint 11 4 11 5 12 5
Rock 4 3 183
Rock 3 6 182
Rock 4 6 183
Rock 6 8 137
Bush 1 2 131
Bush 2 3 132
Bush 10 4 133
Bush 9 6 135
Bush 10 7 135
Bush 14 3 135