16 9 17
25 25 25 25 25 25 25 25 25 25 25 25 25 25 25 25
48 48 48 48 48 48 48 48 48 48 48 48 5  25 25 25
2  2  2  2  2  2  2  2  2  2  2  3  24 25 25 25
25 25 25 25 25 25 25 25 25 25 25 26 24 25 25 25
25 25 25 25 4  48 48 48 48 48 48 49 24 25 25 25
25 25 25 25 26 1  2  2  2  2  2  2  28 25 25 25
25 25 25 25 26 24 25 25 25 25 25 25 25 25 25 25
25 25 25 25 26 47 48 48 48 48 48 48 48 48 48 48
25 25 25 25 27 2  2  2  2  2  2  2  2  2  2  2
Target 14 7 1 1 20
NormalAircraftSpawner 0 1 1 1 10 100 10
TurnPoint 10 1 11 1 11 2
TurnPoint 11 3 11 4 10 4
TurnPoint 5 4 4 4 4 5
TurnPoint 4 6 4 7 5 7
Bush 14 3 132
Bush 1 4 131
Bush 1 5 131
Bush 1 6 131
Bush 2 4 131
Bush 2 6 131
Bush 3 4 131
Bush 3 5 131
Bush 3 6 131
Bush 14 6 135
Bush 15 6 135