16 9 28
173 173 173 174 195 196 196 196 196 196 196 196 196 196 196 153
173 173 173 175 150 150 150 150 150 150 150 150 150 150 151 172
173 173 173 173 173 173 173 173 173 173 173 173 173 173 174 172
232 232 232 232 232 232 232 232 232 232 232 232 232 232 164 162
232 232 232 232 232 232 142 186 186 186 186 143 232 232 164 162
232 232 232 232 232 232 164 139 140 140 141 162 232 232 164 162
232 232 232 232 232 232 164 162 163 163 164 162 232 232 164 162
186 186 186 186 186 186 187 162 163 163 164 185 186 186 187 162
140 140 140 140 140 140 140 166 163 163 165 140 140 140 140 166
Target 3 0 1 1 20
NormalAircraftSpawner 0 7 1 1 30 5 0
BigAircraftSpawner 0 7 1 1 30 20 0
TankerSpawner 0 7 1 1 20 30 10
ElonMuskBossSpawner 0 7 1 1 30 150 1
TurnPoint 5 7 6 7 6 6
TurnPoint 6 5 6 4 7 4
TurnPoint 9 4 10 4 10 5
TurnPoint 10 6 10 7 11 7
TurnPoint 13 7 14 7 14 6
TurnPoint 14 1 14 0 13 0
TurnPoint 4 0 3 0 3 -1
Bush 0 6 131
Bush 1 5 131
Bush 2 5 131
Bush 4 5 131
Bush 9 7 131
Bush 3 4 135
Bush 6 4 133
Bush 9 3 134
Rock 1 1 137
Rock 2 2 136
Rock 6 2 183
Rock 15 0 136
Rock 2 6 182
Rock 8 6 181
Rock 13 4 136
Rock 15 8 138