16 9 20
168 169 167 168 168 237 237 237 237 237 232 232 232 232 232 232
168 169 167 168 168 237 237 237 237 237 232 232 211 255 255 255
168 169 167 168 168 237 237 237 237 237 232 232 233 208 209 209
168 169 167 168 168 237 237 237 237 237 232 232 233 231 232 232
168 169 167 168 168 237 237 237 237 237 232 232 233 231 232 232
168 169 167 168 168 237 237 237 237 237 237 237 238 236 237 237
168 169 190 191 191 260 260 260 260 260 260 260 261 236 237 237
168 170 145 145 145 214 214 214 214 214 214 214 214 240 237 237
168 168 168 168 168 237 237 237 237 237 237 237 237 237 237 237
Target 15 1 1 1 20
KimJongUnBossSpawner 1 0 1 1 200 300 1
TurnPoint 1 5 1 6 2 6
TurnPoint 11 6 12 6 12 5
TurnPoint 12 2 12 1 13 1
Bush 0 1 133
Bush 1 7 132
Bush 10 8 132
Bush 6 2 132
Bush 11 4 134
Bush 14 4 135
Bush 11 1 131
Bush 15 0 131
Bush 7 3 134
Bush 8 5 133
Rock 4 1 137
Rock 3 5 181
Rock 6 5 135
Rock 7 8 182
Rock 15 6 138